Lauren	Hughes
Claire	Peters
Madeleine	Miller
Sebastian	Hodges
Gavin	Campbell
Wanda	Glover
Heather	Harris
Natalie	Wilson
Austin	Ogden
Rebecca	Wilson
Tim	Cameron
Ryan	Coleman
Amanda	Powell
Benjamin	Ross
Chloe	Pullman
Lillian	Sanderson
Matt	Kerr
Katherine	Wright
Frank	Lawrence
Charles	Robertson